{
    "layer": "MUNICIPIOS_DESPUES_2007",
    "property": "GEOCODE",
    "values": [
        "35001",
        "35002",
        "35003",
        "35004",
        "35005",
        "35006",
        "35007",
        "35008",
        "35009",
        "35010",
        "35011",
        "35012",
        "35013",
        "35014",
        "35015",
        "35016",
        "35017",
        "35018",
        "35019",
        "35020",
        "35021",
        "35022",
        "35023",
        "35024",
        "35025",
        "35026",
        "35027",
        "35028",
        "35029",
        "35030",
        "35031",
        "35032",
        "35033",
        "35034",
        "38001",
        "38002",
        "38003",
        "38004",
        "38005",
        "38006",
        "38007",
        "38008",
        "38009",
        "38010",
        "38011",
        "38012",
        "38013",
        "38014",
        "38015",
        "38016",
        "38017",
        "38018",
        "38019",
        "38020",
        "38021",
        "38022",
        "38023",
        "38024",
        "38025",
        "38026",
        "38027",
        "38028",
        "38029",
        "38030",
        "38031",
        "38032",
        "38033",
        "38034",
        "38035",
        "38036",
        "38037",
        "38038",
        "38039",
        "38040",
        "38041",
        "38042",
        "38043",
        "38044",
        "38045",
        "38046",
        "38047",
        "38048",
        "38049",
        "38050",
        "38051",
        "38052",
        "38053",
        "38901"
    ]
}